Accounting	Accounting board
AC_Sale	Used anime products
Actuary	Careful planning
Ai-photo	Portrait shooting
ALLPOST	ALLPOST
AllTogether	O2 board
AnimalGoods	Pet supplies
Anti-ramp	Not a good shop board
AntiVirus	Anti-virus board
Aquarium	Aquarium board
Aqua-shop	Aqua sale
Aromatherapy	Aromatherapy board
Ask	Question Board
Babymother	Motherboard
Bag	Bag board
Bank_Service	Bank service board
Barterbooks	Used book board
Baseball	Baseball board
BeautyBody	Body board
BeautyMarket	Cosmetics trading board
BeautySalon	Sharon board
Beauty	Table special board
Bicycle	Single board
Biker	Motorcycle board
BikerShop	Locomotive sales
Boy-Girl	Men and women board
Brand	Nameplate
Browsers	Explorer
BuyTogether	Purchase board
Cad_Cae	Computer aided design
Car	Car board
Cat	Cat board
CATCH	Self lifting board
C_Chat	Xia Qiaban
Chat82gether	Transfer purchase board items
Chatskill	Conversation skills
China-Drama	Continental drama
Clothes	Used clothing
CMWang	Big tree brother
ComicHouse	Manga House
CompBook	Computer books
Consumer	Consumer protection board
Cookclub	Cooking board
Creditcard	Credit card board
CVS	Supermarket
DC	Digital camera board
Dog	Dog board
DPP	Democratic Progressive Party Board
Drama-ticket	Ticket roll
DSLR	Digital monocular camera sales
DV	DV digital camera
EatToDie	Eat full
Education	Education board
Education	Education issues
Egg-exchange	Twisted Egg Trading
Equal_change	Equivalent exchange
E-shopping	Online shopping board
Examination	National board
EZsoft	Software
Facelift	Medical cosmetic board
FamilyCircle	Hele family board
Fastfood	Fast Food Board
Feminine_sex	Fascist board
Finance	Financial industry
First-wife	Big wife board
Fitness	Fitness board
Food	Gourmet plate
Forsale	Comprehensive secondary trading
Free_box	Free board
Fund	Fund Board
Gamesale	Second-hand game buying and selling
Gardener	Preschool education board
Gay	Gay board
GEPT	All China English
Getmarry	Marriage board
Give	Presentation board
GoodShop	Good shop board
Gossiping	Gossip board
Graduate	Institute board
Guitar	Guitar board
Hairdo	Hairdressing board
Handmade	DIY board
HardwareSale	Used Hardware Trading
Hate	Black Special Board
HelpBuy	Buying board
HK-drama	Hong Kong drama board
Homemaker	Housekeeping
Home-sale	Real estate board
Hypermall	Hypermarkets
IELTS	IELTS board
Insurance	Insurance board
Japanavgirls	AV actress board
Japandrama	Japanese drama board
Japan_Travel	Japan Travel Board
Jawawa	Clip doll board
Jeans	jeans
Joke	[Joke] can be board
joyinDIY	DIY beauty care
Key_Mou_Pad	Keyboard
Kids	Children board
KMT	KMT board
KoreaDrama	Korean drama board
KR_Entertain	Han Guojian
L_BeautyCare	Beauty care board
License	Certification board
LicenseShop	License Book Board
Lifeismoney	Money board
LightNovel	Light-fiction board
Little-Games	Games
LivingGoods	Life Quality Board
Loan	Loan board
LoL	LoL board
Lomo	Lomo camera board
Lottery	Lottery ticket
MacShop	Apple Trading
MakeUp	Beauty makeup board
Mancare	Male maintenance board
Marriage	Marriage board
Marvel	Board
Memento	souvenir
MenTalk	Men topic
Mind	Psychological test
Mix_Match	Street ride
MJ	Mahjong board
MobileComm	Mobile Communications Board
Mobilesales	Mobile trading board
Model	Model board
Movie	Movie board
Multi-lovers	Second board
MuscleBeach	Fitness board
NailSalon	Nail Art
NBA_Film	[Video] NBA FILM
NBA	NBA board
Nb-shopping	Laptop sales
Nightlife	Nightlife board
Office	OFFICE
Old-Games	Old games
Option	Futures and Options
P2PSoftWare	P2P board
Palmar_Drama	Pouch Theatre Board
Pay_home	Housekeeping board
PC_Shopping	Electric shrimp plate
Perfume	Perfume board
Perfume_Shop	Perfume shopping
Pet	Pet board
Photo-buy	Traditional photography sale
PhotoCritic	Photo criticism board
PhotoLink	Web Album Board
Plant	Plant board
PttEarnMoney	Frontal board
Pttlifelaw	Life Law Board
PuzzleDragon	Dragon Puzzle
Q_ary	Questionnaire
Rabbit	Rabbit plate
Railway	Railway board
Rent_apart	Apartment for rent
Rent-exp	Rental experience board
Rent_tao	Suites for rent
Rent_ya	Nice room for rent
RIPE_gender	Cooked board
Sex	Sis board
Share	Share Board
SportLottery	Sports lottery board
SportsShop	Used sporting goods
Sp_teacher	Special teacher
Stock	Stock Market Board
Storage_Zone	Hard disk
Studyteacher	intern teacher
StupidClown	Stupid board
TaiwanDrama	Taiwan drama
Talk	Chat board
Tax	Tax board
Teacher	Teacher board
Teaching	Teaching material board
Tech_Job	Technology board
Teeth_salon	Dental board
Test	Test board
Textbook	Textbook board
Third-person	Third party board
TOEFL_iBT	TOEFL test board
TOEIC	Doyle
ToS	Divine Board
Underwear	Underwear plate
Wanted	Request board
WomenTalk	Girl board
Woodwork DIY	Woodworking DIY board
